
########
#S     #
# ##   #
#   # E#
####  #
#      #
########
