########
#      #
# ##   #
#    # #
####  #
#      #
########